5,5,5,5,5,5,5,5,5,5,5,5,5,5,5,5,5,5,5,5,5,5,5,5,5,5,5,5,5,5,5,5,5
5,5,5,5,5,5,5,5,5,5,5,5,5,5,5,5,5,5,5,5,5,5,5,5,5,5,5,5,5,5,5,5,5
5,5,5,5,5,5,5,5,5,5,5,5,5,5,5,5,5,5,5,5,2,1,1,1,1,3,5,5,5,5,5,5,5
5,5,5,5,5,4,5,5,5,5,5,5,5,5,5,5,5,5,5,5,0,0,0,0,0,0,5,5,5,5,5,5,5
5,5,5,5,5,0,5,5,5,5,5,5,5,5,5,2,1,1,3,5,5,5,5,5,5,5,5,5,5,5,5,5,5
5,2,1,1,3,0,2,3,5,5,5,5,5,5,5,0,0,0,0,5,5,5,5,5,5,5,5,5,5,2,1,1,3
5,0,0,0,0,0,0,0,5,5,5,5,5,5,5,5,5,5,5,5,5,5,5,5,5,5,5,5,5,0,0,0,0
5,5,5,5,5,5,5,5,5,5,2,1,1,1,1,1,1,1,1,3,5,5,5,5,5,5,4,5,5,5,5,5,5
5,5,5,5,5,5,5,5,5,5,0,0,0,0,0,0,0,0,0,0,5,5,5,5,5,5,0,3,5,5,5,5,5
5,5,5,5,5,5,5,5,5,5,5,5,5,5,5,5,5,5,5,5,5,5,5,5,2,3,0,0,2,1,3,5,5
5,5,5,5,5,5,5,5,2,1,1,1,1,1,1,1,1,1,1,3,5,5,5,5,0,0,0,0,0,0,0,5,5
5,5,5,5,5,5,5,5,0,0,0,0,0,0,0,0,0,0,0,0,2,3,5,5,5,5,5,5,5,5,5,5,5
5,5,5,5,5,5,5,2,0,0,0,0,0,0,0,0,0,0,0,0,0,0,5,5,5,5,5,5,5,5,5,5,3
5,2,1,1,1,1,3,0,0,0,0,0,0,0,0,0,0,0,0,0,0,0,2,1,1,1,1,1,1,1,1,1,3
5,0,0,0,0,0,0,0,0,0,0,0,0,0,0,0,0,0,0,0,0,0,0,0,0,0,0,0,0,0,0,0,0
5,0,0,0,0,0,0,0,0,0,0,0,0,0,0,0,0,0,0,0,0,0,0,0,0,0,0,0,0,0,0,0,0
