0,6,6,6,6,6,6,6,6,6,6,6,6,6,6,6,6,6,6,6,6,6,6,6,6,0
6,6,6,6,6,6,6,6,6,6,6,6,6,6,6,6,6,6,6,6,6,6,6,6,6,0
6,6,6,6,6,6,6,6,6,6,6,6,6,6,6,6,6,6,6,6,6,6,6,6,6,6
6,6,6,6,6,2,3,6,6,6,6,6,6,6,6,6,6,6,6,6,6,6,4,6,6,6
6,2,3,6,6,0,0,6,6,6,6,6,6,2,1,1,1,3,6,6,2,3,0,2,1,3
6,0,0,6,6,0,6,6,6,6,6,6,6,0,0,0,0,0,6,6,0,0,0,0,0,0
6,0,6,6,6,0,6,6,2,1,3,6,6,0,6,6,0,6,6,6,0,6,6,6,6,0
6,6,6,6,6,0,2,3,0,0,0,6,6,0,6,6,0,6,6,6,0,6,6,6,6,0
6,2,1,1,3,0,0,0,0,0,0,2,1,1,1,1,1,1,1,1,1,1,1,1,3,0
6,0,0,0,0,0,0,0,0,0,0,0,0,0,0,0,0,0,0,0,0,0,0,0,0,0
6,0,0,0,0,0,6,6,6,6,6,6,6,6,6,6,6,6,6,6,6,6,6,6,6,6
6,0,0,0,0,0,2,1,1,1,1,1,1,1,1,1,1,1,1,1,1,1,1,1,1,3
6,0,0,0,0,0,0,0,0,0,0,0,0,0,0,0,0,0,0,0,0,0,0,0,0,0
